AAREAL BANK AG	AARBESM1XXX
ABBEY NATIONAL BANK, S.A.E.	ABBKESM1XXX
ABN AMRO BANK N.V., S.E.	ABNAESMMXXX
ALLFUNDS BANK, S.A.	ALLFESMMXXX
ALLIED BANKING CORPORATION	ABCMESM1XXX
ALTAE BANCO, S.A.	AHCRESVVXXX
ARESBANK, S.A.	AREBESMMXXX
ARGENTARIA, CAJA POSTAL Y BANCO HIPOTECARIO, S.A.	BBVAESMMXXX
ASSOCIATES CAPITAL CORPORATION, PLC. S.E.	ASSCESM1XXX
ATTIJARIWAFA BANK	BCMAESM1XXX
BANCA CARIGE SPA-CASSA RISPARMIO GENOVA E IMPERIA	CRGEESM1XXX
BANCA CATALANA, S.A.	CATAESBBXXX
BANCA INTESA S.P.A., SUCURSAL EN ESPAÑA	BCITESMMXXX
BANCA JOVER, S.A.	JOVEESBBXXX
BANCA MARCH, S.A.	BMARES2MXXX
BANCA MONTE DEI PASCHI DI SIENA, S.P.A., S.E.	PASCESMMXXX
BANCA NAZIONALE DEL LAVORO, S.P.A., S.E.	BNLIESM1XXX
BANCA PUEYO, S.A.	BAPUES22XXX
BANCO ALCALA, S.A.	ALCLESMMXXX
BANCO BANIF, S.A.	NORTESMMXXX
BBVA BANCO BILBAO VIZCAYA ARGENTARIA, S.A.	BBVAESMMXXX
BANCO BPI, S.A., S.E.	BBPIESMMXXX
BANCO CAIXA GERAL, S.A.	CGDIESMMXXX
BANCO CAMINOS, S.A.	CCOCESMMXXX
BANCO CANARIAS DE VENEZUELA, CA	BOCAES21XXX
BANCO CENTRAL HISPANOAMERICANO, S.A.	CENTESMM
BANCO CETELEM, S.A.	FIEIESM1XXX
BANCO CONDAL, S.A.	BCNDESM1XXX
BANCO COOPERATIVO ESPAÑOL, S.A.	BCOEESMMXXX
BANCO DE ALICANTE, S.A.	BBVAESMMXXX
BANCO DE ANDALUCIA, S.A.	BANDESSSXXX
BANCO DE ASTURIAS, S.A.	ASTUESMMXXX
BANCO DE CASTILLA, S.A.	CASTES2SXXX
BANCO DE CREDITO AGRICOLA, S.A.	BCAEESMM
BANCO DE CREDITO BALEAR, S.A.	BALEES22XXX
BANCO DE CREDITO LOCAL DE ESPAÑA, S.A.	BCLEESMMXXX
BANCO DE DEPOSITOS, S.A.	BDEPESM1XXX
BANCO DE EXTREMADURA, S.A.	CGDIES2CXXX
BANCO DE FINANZAS E INVERSIONES, S.A.	BFIVESBBXXX
BANCO DE GALICIA, S.A.	GALIES2VXXX
BANCO DE LA NACION ARGENTINA, S.E.	NACNESMMXXX
BANCO DE LA PEQUEÑA Y MEDIANA EMPRESA, S.A.	BPMEESBBXXX
BANCO DE LA PROVINCIA DE BUENOS AIRES	PRBAESM1XXX
BANCO DE LAS ACTIVIDADES ECONOMICAS EXTERIORES	AEEVESM1XXX
BANCO DE MADRID, S.A.	MADRESMMXXX
BANCO DE MURCIA, S.A.	BAMUES22XXX
BANCO DE NEGOCIOS ARGENTARIA, S.A.	BNARESMMXXX
BANCO DE PROMOCION DE NEGOCIOS, S.A. (PROMOBANC)	PRNEESM1XXX
BANCO DE SABADELL, S.A.	BSABESBBXXX
BANCO DE VALENCIA, S.A.	VALEESVVXXX
BANCO DE VASCONIA, S.A.	VASCES2PXXX
BANCO DE VITORIA, S.A.	BVICES21XXX
BANCO DEL COMERCIO, S.A.	BCIOESMMXXX
BANCO DEL DESARROLLO ECONOMICO ESPAÑOL, S.A.	DEEEESM1XXX
BANCO DEPOSITARIO BBVA, S.A.	BVADESMMXXX
BANCO DI NAPOLI, S.P.A., S.E.	NAPBESMMXXX
BANCO DIRECTO, S.A.	BADIESMMXXX
BANCO DO BRASIL, S.A., S.E.	BRASESMMXXX
BANCO DO ESTADO DE SAO PAULO, S.A., S. MADRID	BESPESMMXXX
BANCO ESPAÑOL DE CREDITO, S.A.	ESPCESMMXXX
BANCO ESPIRITO SANTO DE INVESTIMENTO, S.A., S.E.	ESSIESMMXXX
BANCO ESPIRITO SANTO S.A. S.E.	BESCESMMXXX
BANCO ESPIRITO SANTO, S.A., S.E.	BESMESMMXXX
BANCO ETCHEVERRIA, S.A.	ETCHES2GXXX
BANCO EUROPEO DE FINANZAS, S.A.	BEDFESM1XXX
BANCO EXELBANK, S.A.	IXIUESM1XXX
BANCO EXTERIOR DE ESPAÑA, S.A.	EXTEESMMXXX
BANCO FINANTIA SOFINLOC, S.A.	ESFIESM1XXX
BANCO GALLEGO, S.A.	MDBOESM1XXX
BANCO GALLEGO, S.A.	GALEES2GXXX
BANCO GUIPUZCOANO, S.A.	BGUIES22XXX
BANCO HALIFAX HISPANIA, S.A.	HLFXESMMXXX
BANCO HERRERO, S.A.	BHROESM2XXX
BANCO INDUSTRIAL DE BILBAO, S.A.	INBBESM1XXX
BANCO INTERNACIONAL, S.A.	BIMEESM1XXX
BANCO INVERSIS, S.A.	INVLESMMXXX
BANCO NACIONAL DE CUBA	BNACESM1XXX
BANCO OCCIDENTAL, S.A.	OCBAESM1XXX
BANCO PASTOR, S.A.	PSTRESMMXXX
BANCO POPULAR ESPAÑOL, S.A.	POPUESMMXXX
BANCO POPULAR HIPOTECARIO, S.A.	POHIESM1XXX
BANCO PORTUGUES DE INVESTIMENTO, S.A. S.E.	BPIPESM1XXX
BANCO PORTUGUES DO ATLANTICO, SUCURSAL EN ESPAÑA	ILBKESMMXXX
BANCO SANTANDER CENTRAL HISPANO, S.A.	BDERESMMXXX
BANCO SANTANDER, S.A.	BSCHESMMXXX
BANCO SBS-AGRO	STOLESM1XXX
BANCO SERVICIOS FINANCIEROS CAJA MADRID-MAPFRE,SA	BMAPESM1XXX
BANCO SIMEON, S.A.	CGDIES2VXXX
BANCO STANDARD CHARTERED S.E.	BSCEESMMXXX
BANCO SYGMA HISPANIA, S.E.	SHSAESM1XXX
BANCO URQUIJO SABADELL BANCA PRIVADA, S.A.	UIJOESMMXXX
BANCO URQUIJO, S.A.	PROGESMM
BANCOFAR, S.A.	BAOFESM1XXX
BANCO POPULAR-E, S.A.	POPLESMMXXX
BANK J. VONTOBEL & CO. AG.	VONTESM1XXX
BANK OF AMERICA, NATIONAL ASSOCIATION, S.E.	BOFAES2XXXX
BANK OF AMERICA, S.A.	BOFAES2XXXX
BANKINTER, S.A.	BKBKESMMXXX
BANKOA, S.A.	BKOAES22XXX
BANQUE COURTOIS	COURESB1XXX
BANQUE INTERNATIONALE A LUXEMBOURG	BILLESB1XXX
BANQUE MAROCAINE COMMERCE EXTERIEUR INTERNAT.,S.A.	BMCEESMMXXX
BANQUE PRIVEE EDMOND DE ROTHSCHILD EUROPE, S.E	PRIBESMXXXX
BANQUE PSA FINANCE, S.E.	PSABESM1XXX
BANQUE REGIONALE D’ESCOMPTE ET DE DEPOTS	REDEESM1XXX
BANQUE SCANDINAVE EN SUISSE	SCSIESM1XXX
BANQUE SCS ALLIANCE	BSSAESB1XXX
BANQUE SUDAMERIS	BSUDESM1XXX
BARCLAYS BANK PLC, S.E.	BPLCESMMXXX
BARCLAYS BANK, S.A.	BARCESMMXXX
BAYERISCHE HYPO- UND VEREINSBANK AG.	HYVEESM1XXX
BBVA BANCO DE FINANCIACION, S.A.	INALESM1XXX
BES INVESTIMENTO SA	BEIVESM1XXX
BILBAO BIZKAIA KUTXA,AURREZKI KUTXA ETA BAHITETXEA	BASKES2BXXX
BNP PARIBAS ESPAÑA, S.A.	BNPAESMMXXX
BNP PARIBAS SECURITIES SERVICES, S.E.	PARBESMXXXX
BNP PARIBAS, S.E.	BNPAESMSXXX
C.A.M.P. CIRCULO CATOLICO DE OBREROS DE BURGOS	CECAESMM017
CAISSE NATIONALE DE CREDIT AGRICOLE, SUC. ESPAÑA	AGRIESMM
CAISSE REGIONALE CREDIT AGRICOLE MUTUEL SUD MED,SE	CRCGESB1XXX
CAIXA AFORROS VIGO,OURENSE E PONTEVEDRA(CAIXANOVA)	CAVIES2VXXX
CAIXA DE C. DELS ENGINYERS-C.C. INGENIEROS, S.C.C	CDENESBBXXX
CAIXA DELS ADVOCATS-CAJA DE LOS ABOGADOS, S.C.C.	CXAVESB1XXX
CAIXA D’ESTALVIS COMARCAL DE MANLLEU	CECAESMM040
CAIXA D’ESTALVIS DE CATALUNYA	CESCESBBXXX
CAIXA D’ESTALVIS DE GIRONA	CECAESMM030
CAIXA D’ESTALVIS DE MANRESA	CECAESMM041
CAIXA D’ESTALVIS DE SABADELL	CECAESMM059
CAIXA D’ESTALVIS DE TARRAGONA	CECAESMM073
CAIXA D’ESTALVIS DE TERRASSA	CECAESMM074
CAIXA D’ESTALVIS DEL PENEDES	CECAESMM081
CAIXA D’ESTALVIS LAIETANA	CECAESMM042
CAIXA POPULAR-CAIXA RURAL, S.C.C.V.	BCOEESMM159
CAIXA R. ALBALAT DELS SORELLS, C.C.V.	BCOEESMM186
CAIXA R. ALTEA, C.C.V.	BCOEESMM045
CAIXA R. BENICARLO, S.C.C.V.	BCOEESMM162
CAIXA R. D’ALGEMESI, S.C.V.C.	BCOEESMM117
CAIXA R. DE BALEARS, S.C.C.	BCOEESMM147
CAIXA R. DE CALLOSA D’EN SARRIA, C.C.V.	BCOEESMM105
CAIXA R. DE L’ALCUDIA, S.C.V.C.	BCOEESMM096
CAIXA R. DE TURIS, C.C.V.	BCOEESMM123
CAIXA R. GALEGA, S.C.C.L.G.	BCOEESMM070
CAIXA R. LA VALL ‘S. ISIDRO’, S.C.C.V.	BCOEESMM111
CAIXA R. S. VICENT FERRER DE LA VALL D’UIXO,C.C.V.	BCOEESMM102
CAIXA R. VINAROS, S.C.C.V.	BCOEESMM174
CAIXA R.S.JOSEP DE VILAVELLA, S.C.C.V.	BCOEESMM160
CAIXA RURAL LES COVES DE VINROMA, S.C.C.V.	BCOEESMM166
CAIXA RURAL TORRENT C.C.V.	BCOEESMM118
CAIXABANK, S.A.	CBANESBBXXX
CAJA AH. VALENCIA, CASTELLON Y ALICANTE, BANCAJA	CVALESVVXXX
CAJA CAMINOS, S.C.C.	CCOCESMMXXX
CAJA CAMPO, CAJA RURAL, S.C.C.	BCOEESMM094
CAJA DE AH. PROV. SAN FERNANDO DE SEVILLA Y JEREZ	CECAESMM071
CAJA DE AHORRO PROVINCIAL DE GUADALAJARA	CECAESMM032
CAJA DE AHORROS DE ASTURIAS	CECAESMM048
CAJA DE AHORROS DE CASTILLA-LA MANCHA	CECAESMM105
CAJA DE AHORROS DE GALICIA	CAGLESMMXXX
CAJA DE AHORROS DE LA INMACULADA DE ARAGON	CECAESMM086
CAJA DE AHORROS DE LA RIOJA	CECAESMM037
CAJA DE AHORROS DE MURCIA	CECAESMM043
CAJA DE AHORROS DE SALAMANCA Y SORIA	CSSOES2SXXX
CAJA DE AHORROS DE SANTANDER Y CANTABRIA	CECAESMM066
CAJA DE AHORROS DE VITORIA Y ALAVA	CECAESMM097
CAJA DE AHORROS DEL MEDITERRANEO	CAAMES2AXXX
CAJA DE AHORROS MUNICIPAL DE BURGOS	CECAESMM018
CAJA DE AHORROS Y M.P. DE AVILA	CECAESMM094
CAJA DE AHORROS Y M.P. DE CORDOBA	CECAESMM024
CAJA DE AHORROS Y M.P. DE EXTREMADURA	CECAESMM099
CAJA DE AHORROS Y M.P. DE GIPUZKOA Y SAN SEBASTIAN	CGGKES22XXX
CAJA DE AHORROS Y M.P. DE LAS BALEARES	CECAESMM051
CAJA DE AHORROS Y M.P. DE MADRID	CAHMESMMXXX
CAJA DE AHORROS Y M.P. DE NAVARRA	CANVES2PXXX
CAJA DE AHORROS Y M.P. DE ONTINYENT	CECAESMM045
CAJA DE AHORROS Y M.P. DE SEGOVIA	CECAESMM069
CAJA DE AHORROS Y M.P. DE ZARAGOZA, ARAGON Y RIOJA	CAZRES2ZXXX
CAJA DE AHORROS Y PENSIONES DE BARCELONA	CAIXESBBXXX
CAJA DE ARQUITECTOS S.C.C.	CASDESBBXXX
CAJA DE CREDITO DE PETREL, CAJA RURAL, C.C.V.	BCOEESMM029
CAJA DE ELCHE, CAJA RURAL, C.C.V.	BCOEESM1181
CAJA ESPAÑA DE INVERSIONES, CAJA DE AHORROS Y M.P.	CSPAES2LXXX
CAJA GENERAL DE AHORROS DE CANARIAS	CECAESMM065
CAJA GENERAL DE AHORROS DE GRANADA	CECAESMM031
CAJA INSULAR DE AHORROS DE CANARIAS	CECAESMM052
CAJA LABORAL POPULAR C.C.	CLPEES2MXXX
CAJA PROVINCIAL DE AHORROS DE JAEN	CECAESMM092
CAJA R. ARAGONESA Y DE LOS PIRINEOS, S.C.C.	BCOEESMM189
CAJA R. BAENA NTRA. SRA. GUADALUPE S.C.C.A.	BCOEESMM089
CAJA R. CASTELLON S. ISIDRO, S.C.C.V.	BCOEESMM114
CAJA R. CATOLICO AGRARIA, S.C.C.V.	BCOEESMM110
CAJA R. CENTRAL, S.C.C.	BCOEESMM005
CAJA R. COMARCAL DE MOTA DEL CUERVO, S.C.L.C.A.	BCOEESMM116
CAJA R. CREDICOOP, S.C.C.	CRCPES2CXXX
CAJA R. DE ALBACETE, S.C.C.	BCOEESMM056
CAJA R. DE ALBAL, C.C.V.	BCOEESMM150
CAJA R. DE ALGINET, S.C.C.V.	BCOEESMM179
CAJA R. DE ARAGON, S.C.C.	BCOEESMM021
CAJA R. DE ASTURIAS, S.C.C.	BCOEESMM059
CAJA R. DE BETXI, S.C.C.V.	BCOEESMM138
CAJA R. DE BURGOS,S.C.C.	BCOEESMM060
CAJA R. DE CANARIAS, S.C.C.	BCOEESMM177
CAJA R. DE CAÑETE TORRES NTRA.SRA.DEL CAMPO,S.C.A.	BCOEESMM104
CAJA R. DE CASAS IBAÑEZ, S.C.C.CASTILLA-LA MANCHA	BCOEESMM127
CAJA R. DE CASINOS S.C.C.V.	BCOEESMM137
CAJA R. DE CHESTE, S.C.C.	BCOEESMM121
CAJA R. DE CIUDAD REAL, S.C.C.	BCOEESMM062
CAJA R. DE CORDOBA, S.C.C.	BCOEESMM063
CAJA R. DE CUENCA, S.C.C.	BCOEESMM064
CAJA R. DE EXTREMADURA, S.C.C.	BCOEESMM009
CAJA R. DE FUENTEPELAYO, S.C.C.	BCOEESMM022
CAJA R. DE GIJON, C.C	BCOEESMM007
CAJA R. DE GRANADA, S.C.C.	BCOEESMM023
CAJA R. DE GUISSONA, S.C.C.	BCOEESMM140
CAJA R. DE HUESCA, S.C.C.	BCOEESMM066
CAJA R. DE JAEN, BARCELONA Y MADRID, S.C.C.	BCOEESMM067
CAJA R. DE LA RODA, S.C.C. DE CASTILLA LA MANCHA	BCOEESMM128
CAJA R. DE NAVARRA, S.C.C.	BCOEESMM008
CAJA R. DE SALAMANCA, S.C.C.	BCOEESMM016
CAJA R. DE SEGOVIA, C.C.	BCOEESMM078
CAJA R. DE SORIA, S.C.C.	BCOEESMM017
CAJA R. DE TERUEL, S.C.C.	BCOEESMM080
CAJA R. DE TOLEDO, S.C.C.	BCOEESMM081
CAJA R. DE UTRERA, S.C.A.C.	BCOEESMM020
CAJA R. DE VILLAMALEA, S.C.C.A. CASTILLA-LA MANCHA	BCOEESMM144
CAJA R. DE VILLAR C.C.V.	BCOEESMM152
CAJA R. DE ZAMORA, C.C.	BCOEESMM085
CAJA R. DE ZARAGOZA, S.C.C.	BCOEESMM092
CAJA R. DEL CAMPO DE CARIÑENA, S.C.C.L.	BCOEESM1093
CAJA R. DEL DUERO, S.C.C.L.	BCOEESMM083
CAJA R. DEL MEDITERRANEO, RURALCAJA, S.C.C.	BCOEESMM082
CAJA R. DEL SUR, S. COOP. DE CREDITO	BCOEESMM187
CAJA R. LA JUNQUERA DE CHILCHES, S.C.C.V.	BCOEESMM157
CAJA R. NTRA. SRA. DEL ROSARIO, S.C.A.C.	BCOEESMM098
CAJA R. NTRA. SRA. LA ESPERANZA DE ONDA, S.C.C.V.	BCOEESMM134
CAJA R. ‘NUESTRA MADRE DEL SOL’, S.C.A.C.	BCOEESMM115
CAJA R. S. FORTUNATO, S.C.C.C.L.	BCOEESMM161
CAJA R. S. ISIDRO DE VILAFAMES, S.C.C.V.	BCOEESMM165
CAJA R. S. JAIME ALQUERIAS NIÑO PERDIDO S.C.C.V.	BCOEESMM119
CAJA R. S. JOSE DE ALCORA S.C.C.V.	BCOEESMM113
CAJA R. S. JOSE DE ALMASSORA, S.C.C.V.	BCOEESMM130
CAJA R. S. JOSE DE BURRIANA, S.C.C.V.	BCOEESMM112
CAJA R. S. JOSE DE NULES S.C.C.V.	BCOEESMM135
CAJA R. S. ROQUE DE ALMENARA S.C.C.V.	BCOEESMM095
CAJA R.R.S.AGUSTIN DE FUENTE ALAMO M., S.C.C.	BCOEESMM018
CAJAMAR CAJA RURAL, S.C.C.	CCRIES2AXXX
CAJASIETE, CAJA RURAL, S.C.C.	BCOEESMM076
CALYON, S.E.	BSUIESMMXXX
CASSA RISPARMIO PROVINCIE LOMBARDE(CARIPLO)SPA,S.E	CARIESMMXXX
CELERIS SERVICIOS FINANCIEROS, S.A., E.F.C.	CSFAESM1XXX
CITIBANK ESPAÑA, S.A.	CITIES2XXXX
CITIBANK INTERNATIONAL PLC, S.E.	CITIESMXXXX
COLONYA – CAIXA D’ESTALVIS DE POLLENSA	CECAESMM056
COMMERZBANK AKTIENGESELLSCHAFT, S.E.	COBAESMXXXX
COMPAGNIE BANCAIRE, SUCURSAL EN ESPAÑA	COBFFRPPXXX
CONFEDERACION ESPAÑOLA DE CAJAS DE AHORROS	CECAESMMXXX
COOP.CENTR. RAIFFEISEN-BOERENL.(RABOBANK NED.)S.E.	PRABESMMXXX
CREDIT AGRICOLE LEASING, S.E.	UCSSESM1XXX
CREDIT COMMERCIAL DE FRANCE, S.E.	CCFRESMMXXX
CREDIT LYONNAIS ESPAÑA, S.A.	CRLEESMMXXX
CREDIT SUISSE FIRST BOSTON, S.E.	CRESESMMXXX
CREDIT SUISSE, S.E.	CRESESMMXXX
CREDIT VALENCIA, C.R.C.C.V.	BCOEESMM188
DE LAGE LANDEN INTERNATIONAL B.V., S.E.	LLISESM1XXX
DEUTSCHE BANK A.G., S.E.	DEUTESM1XXX
DEUTSCHE BANK CREDIT, S.A.	DECRESM1XXX
DEUTSCHE BANK TRUST COMPANY AMERICAS, S.E.	BKTRESM1XXX
DEUTSCHE BANK, S.A.E.	DEUTESBBXXX
DEXIA BANCO LOCAL, S.A.	DBOLESM1XXX
DEXIA SABADELL, S.A.	DSBLESMMXXX
DRESDNER BANK A.G., S.E.	DRESESMXXXX
DZ BANK AG DEUTSCHE ZENTRAL-GEN., FRANKFURT A.M.	GENOESM1XXX
EBN BANCO DE NEGOCIOS, S.A.	PROAESMMXXX
EFG BANK (LUXEMBOURG) S.A., S.E.	EFGBESMMXXX
EQUITABLE P.C.I. BANK	PCIBESM1XXX
ESPIRITO SANTO BANK OF FLORIDA	ESBFESM1XXX
EUROHYPO A.G. EUROPAISCHE HYPOTHEKENBANK D.B.,S.E.	EEHDESM1XXX
EUROHYPO A.G., S.E.	EHYPESM1XXX
EUROPE ARAB BANK PLC, S.E.	ARABESMMXXX
FCE BANK PLC S.E.	FCEFESM1XXX
FINANZIA, BANCO DE CREDITO, S.A.	FICDESM1XXX
FORTIS BANK, S.A., S.E.	GEBAESMMXXX
FRANFINANCE, S.E.	FRANESM1XXX
GENERAL ELECTRIC CAPITAL BANK, S.A.	GEECESB1XXX
HISPAMER BANCO FINANCIERO, S.A.	BAFOESMM
HSBC BANK PLC, S.E.	MIDLESMMXXX
IKB DEUTSCHE INDUSTRIEBANK AG	IKBDESM1XXX
ING BELGIUM, S.A., S.E.	BBRUESMXXXX
ING DIRECT, N.V. S.E.	INGDESMMXXX
INSTITUTO DE CREDITO OFICIAL	ICROESMMXXX
INTESA SANPAOLO S.P.A., S.E.	BCITESMMXXX
IPAR KUTXA RURAL, S.C.C.	CVRVES2BXXX
JPMORGAN CHASE BANK NATIONAL ASSOCIATION, S.E.	CHASESM3XXX
KBC BANK NV, S.E.	KREDESMMXXX
LANDESBANK BADEN-WÜRTTEMBERG	SOLAESB1XXX
LANDESBANK HESSEN-THUERINGEN GIROZENTRALE	HELAESM1XXX
LLOYDS TSB BANK PLC, S.E.	LOYDESMMXXX
LONDON FORFAITING A PARIS, S.A.	LOFPESB1XXX
M.P. Y C.A. SAN FERNANDO DE HUELVA JEREZ Y SEVILLA	CECAESMM106
M.P. Y CAJA DE AHORROS DE HUELVA Y SEVILLA	CECAESMM098
M.P. Y CAJA GENERAL AHORROS DE BADAJOZ	CECAESMM010
M.P.C.A. RONDA, CADIZ, ALMERIA, MALAGA Y ANTEQUERA	UCJAES2MXXX
MERRILL LYNCH INTERNATIONAL BANK LTD., S.E.	MLCBESM1XXX
MERRILL LYNCH INTERNATIONAL BANK LTD., S.E.	MLIBESM1XXX
MIZUHO CORPORATE BANK LTD. S.E.	IBJTESM1XXX
MORGAN GUARANTY TRUST COMPANY OF NEW YORK, S.E.	MGTCESMXXXX
NATIONAL WESTMINSTER BANK PLC, S.E.	NWBKESMXXXX
NATIXIS, S.A., S.E.	BFCEESMMXXX
NEWCOURT FINANCE (FRANCE) S.N.C., S.E.	NFFSESM1XXX
NEWEDGE GROUP, S.E.	NEWGESM1XXX
NORWICH AND PETERBOROUGH BUILDING SOCIETY	NPBSES21XXX
OPEN BANK SANTANDER CONSUMER, S.A.	OPENESMMXXX
PHILIPPINE NATIONAL BANK, S.A.	PNBMESM1XXX
PKB PRIVATBANK AG.	PKBSES21XXX
POPULAR BANCA PRIVADA, S.A.	POPIESMMXXX
PRIVAT BANK, S.A.	PRVBESB1XXX
PRIVATBANK IHAG ZURICH	IHZUES21XXX
PROBANCA, SERVICIOS FINANCIEROS, S.A.	PROAESMMXXX
RABOBANK ESPAÑA, S.A.	PRABESMMXXX
RBC DEXIA INVESTOR SERVICES ESPAÑA, S.A.	BVALESMMXXX
RHEINHYP RHEINISCHE HYPOTHEKENBANK A.G.	RHRHESM1XXX
ROYAL BANK OF CANADA EUROPE LIMITED, S.E.	ROYCESM1XXX
ROYAL BANK OF CANADA, SUCURSAL EN ESPAÑA	ROYCESM1XXX
SANTANDER CONSUMER FINANCE, S.A.	SCFBESMMXXX
SANTANDER INVESTMENT, S.A.	SABNESMMXXX
SELF TRADE BANK, S.A.	SELFESM1XXX
SINDICATO DE BANQUEROS DE BARCELONA, S.A.	SIBBESBBXXX
SOCIETE GENERALE, S.E.	SOGEESMMXXX
SOLBANK SBD, S.A.	SLBKESBBXXX
STANDARD CHARTERED BANK	SCBLESM1XXX
SVENSKA HANDELSBANKEN	HANDES21XXX
THE BANK OF NEW YORK MELLON	IRVTESM1XXX
THE BANK OF TOKYO-MITSUBISHI UFJ, LTD, S.E.	BOTKESMXXXX
THE DAI-ICHI KANGYO BANK LIMITED, S.E.	DKBBESM1XXX
THE FUJI BANK LIMITED, S.E.	FUJIJPJTXXX
THE SAKURA BANK LIMITED, S.E.	MITKESM1XXX
THE SANWA BANK LIMITED, S.E.	SANWESM1XXX
THE SUMITOMO BANK, S.E.	SMITESMXXXX
TRIODOS BANK, N.V., S.E.	TRIOESMMXXX
UBI BANCA INTERNATIONAL, S.A., S.E.	UBIBESMMXXX
UBS BANK, S.A	UBSWESMMXXX
UBS, A.G. S.E.	UBSWESMMXXX
UNICREDIT SOCIETA PER AZIONI, S.E.	UNCRESMMXXX
UNION DE CREDITOS INMOBILIARIOS, S.A., E.F.C.	UCINESMMXXX
UNOE BANK, S.A.	UNOEESM1XXX
VOLKSWAGEN BANK GMBH, S.E.	VOWAES21XXX
WAFABANK	WAFAESM1XXX
WESTLB AG, S.E.	WELAESMMXXX